W, W, W, W, W, W, W, W, W, W, W, W, W, W, W, W,
W, W, W, W, W, W, W, W, W, W, W, W, W, W, W, W,
W, W, W, W, W, W, W, W, W, W, W, W, W, W, W, W,
W, W, W, W, W, W, W, W, W, W, W, TR, W, W, W, W,
W, W, W, W, W, W, W, W, W, W, W, B, W, W, W, W,
W, W, W, W, W, B, B, W, W, W, W, B, W, W, W, W,
W, W, W, W, W, B, B, W, W, W, B, B, B, B, W, W,
W, W, B, B, B, B, B, W, W, B, B, B, B, B, W, W,
W, B, B, B, B, B, B, W, W, B, B, B, B, B, W, W,
W, B, B, W, B, B, B, B, B, B, B, B, B, B, W, W,
B, B, RR, W, W, B, B, B, B, B, W, B, W, B, W, W,
B, B, B, W, W, W, W, W, W, W, W, B, W, B, W, W,
B, B, B, W, W, W, W, W, W, W, W, B, B, B, W, W,
W, W, W, W, W, W, W, W, W, W, W, W, W, W, W, W,
W, W, W, W, W, W, W, W, W, W, W, W, W, W, W, W,
W, W, W, W, W, W, W, W, W, W, W, W, W, W, W, W